wwwwwwwwwwwwwwwwwwwwwwwwwwwwwwwwp2PPPPPGG
wwwwwwwwwwwwwwwwwwwwwwwwwwwwwwwwp2PPPPPGG
wwwwwwwwwwwwwwwwwwwwwwwwwwwwwwwwp21114PGG
wwwwwwwwwwwwwwwwwwwwwwwwwwwwwwwwp2PPP0PGG
OOOOOOOOOOOOOOOOOOOOOOOOOOwwwwwwp2PPP0PGG
33333333333333333333333389OOOOOOO2PPP0PGG	
PPPPPPPPPPPPPPPPPPPPPPPP0511111111PPP0PGG
PPPPPPPPPPPPPPPPPPPPPPPP00PPGGGGGGGPP1PGG
GGGGPPPPPPPPPGGGGPA1111170PPGGGGGGGPP2PGG
GGGGP1111118PGGGGP0PPPPP22PPGGGGGGGPP2PGG
GGGGPPPPPPP0PGGGGP0PPPPP22PPPPPPPPPPP2PGG
GGGPPPPPPPP0PGGGGP0PPPPP22111111111112PGG
GGGPPPPPPPP0PPPPPP0PPPPP22PPPPP0PPPPPPPGG
GGGPPPPPPPP91111117PPPPP22PPPPP3PggggggGG
GGLPPPPPPPP0PPPPPPPPPPPP22PPPPP2PGGGGGGGG
GGLA11111118PPPPPPPPPPPP22PPPPP2PGGGGGGGG
GGL0PPPPPPP0PPPPPPPGGGGP22PPPPP2PGGGGGGGG
GGL0PGGGGGP0PPPPPPPGGGGP22PGGGP2PGGGGGGGG
GGL0PPPPPPP0PPPPPPPPPPPP22PGGGP2PPPPPPPPP
GGL91111111311111111111132PGGGP311111118P
GGLPPPPPPPP9A1111111111A22PGGGP2PPPPPPP0P
GGGPPPPPPPP00PPPPPPPPPP0PPPGGGP2PGGGGGP2P
GGGPPPPPPPP00PGGGUUUUUU0PPGGGGP2PGGGGGP2P
GGGPPPPPPPP00PGGGP111113PPGGGGP2PGGGGGP2P
GGGPPPPPPPP00PGGPPPPPPP0PPPPPPP2PGGGGGP2P
GGGPPPPPPPP00PGGPPPPPPP0PPPPPPP2PGGGGGP2P
GGGGGPPPPPP00PGGPPPPPPP0PPPPPPP2PPPPPPP2P
GGGGGPPPPPP00PGGPPPPPPP91111111311111113P
GGGGGPPPPPP00PGGPPPPPPP0PPPPPPPPPPPPPPPPP
GGGGGPPPPPP00PGGGP111113PPPPPPPPPPPPPGGGG
GGGGGPPPPPP00PPPPPPPPPP0PPPPPPPPPP2PPGGGG
GGGPPPPPPPP00PGGGPPPPPP0PPPPPPPPPP2PPGGGG
GGGPPA1111182PGGGPPPPPP9118PPPPPPP2PPGGGG
GGGPP1A111182PGGGPPPPPPPPP1PPPPPPP2PPPPGG
GGGPP00PPPPPPPGGGP0PPPPPPP911113111111PGG
GGGPP00PGGGGGPGGGP0PPPPPPP0PPPP0PPPPPPPGG
GGGPP00PGPPPPPPPPP0PPPPPPP0PPPP0PPGGGGGGG
GGGPP00PGP11111111311111117PPPP0PPPGGGGGG
GGGPP00PGPPPPPPPPPPPPPPPPPPPPPP911PGGGGGG
GGGPP00PGGGGGGGGGGGGGGGGGGGGGGgggggGGGGGG
GGGPP00PGGGGGGGGGGGGGGGGGGGGGGGGGGGGGGGGG